########################
#K..#..................#
#...#.......#..........#
#K..#.......#..........#
#...#...Z...#..........#
#.Z.#.......#..........#
#...#.......#....Z.....#
#...#.......#..........#
#...........#.........P#
########################